#####  ########
#S            #
#  #########  #
#  #       #  #
#  #  ###  #  ##
#  #  #E#  #  #
#  #### ###  # 
#            # 
###############