#####
#S  #
#   #
# E##
#####
#