#####  ########
#S            #
#  #########  #
#  #       #  #
#  #  ###  #  #
#  #  ##  #  # 
#  #### ###  # 
#            # 
###############